+---+---+---+---+---+---+---+---+---+---+---+---+---+---+---+---+
|                   |           |   |       |   |   |   |       |
+---+   +   +---+---+   +   +---+   +   +   +   +   +   +   +---+
|       |       |       |       |       |       |               |
+   +---+---+   +   +---+---+   +   +---+   +---+---+   +   +---+
|       |       |       |       |       |       |       |       |
+---+   +   +---+---+   +   +---+---+   +---+   +   +---+---+   +
|       |       |       |       |       |       |       |       |
+   +---+---+   +   +---+---+   +   +---+   +---+---+   +   +---+
|       |       |       |       |       |       |       |       |
+---+   +   +---+---+   +   +---+---+   +---+   +   +---+---+   +
|       |       |       |                   |           |       |
+   +---+---+   +   +---+---+   +   +---+---+---+---+---+   +---+
|       |   |       |       |       |       |       |           |
+---+   +   +   +   +   +   +---+---+   +   +   +   +   +   +---+
|       |       |       |   |       |   |       |       |       |
+   +---+---+---+---+---+---+   +   +   +---+---+---+---+---+---+
|       |       |       |           |       |       |           |
+---+   +   +   +   +   +   +---+---+   +   +   +   +   +   +---+
|           |       |       |           |       |       |       |
+   +---+---+---+---+---+---+---+---+---+---+---+---+---+   +   +
|   |       |       |       |       |       |       |       |   |
+---+   +   +   +   +   +   +   +   +   +   +   +   +   +   +---+
|       |       |       |       |       |       |       |       |
+   +---+---+---+---+---+---+---+---+---+---+---+---+---+---+---+
|   |       |       |       |       |       |       |       |   |
+   +   +   +   +   +   +   +   +   +   +   +   +   +   +   +   +
|       |       |       |       |       |       |       |       |
+---+---+---+---+---+---+---+---+---+---+---+---+---+---+---+   +
|       |       |       |       |       |       |       |       |
+   +   +   +   +   +   +   +   +   +   +   +   +   +   +   +   +
|   |       |       |       |       |       |       |       |   |
+---+---+---+---+---+---+---+---+---+---+---+---+---+---+---+---+

[14,12,6,12,6,12,6,12,6,12,6,12,6,12,6,14,24,18,24,18,24,18,24,18,24,18,24,18,24,18,24,2,12,6,12,6,12,6,12,6,12,6,12,6,12,6,12,2,10,24,18,24,18,24,18,24,18,24,18,24,18,24,18,26,24,6,12,6,12,6,12,6,12,6,12,6,12,6,12,22,14,24,18,24,18,24,18,24,18,24,18,24,18,24,2,14,24,4,6,12,6,12,6,28,20,6,12,6,12,6,8,18,12,18,24,18,24,18,24,4,6,8,18,24,18,24,16,22,24,6,12,6,12,6,14,24,18,10,12,6,12,6,12,22,12,18,26,8,2,24,18,12,6,24,18,24,18,24,0,22,24,6,12,18,24,6,12,16,16,4,22,12,4,22,24,6,12,18,24,6,12,18,24,6,12,18,12,18,24,6,12,18,24,6,12,18,24,6,12,18,24,6,24,6,12,18,24,6,12,18,24,6,12,18,24,6,12,18,12,18,24,6,12,18,24,6,12,18,24,6,12,18,8,6,8,6,12,0,0,22,28,16,16,20,22,24,16,22,26,24,18,26,26,26,24,22]